                   0 row=  0, col=   0,red=0
                  10 row=  0, col=   1,red=0
                  20 row=  0, col=   2,red=0
                  30 row=  0, col=   3,red=0
                  40 row=  0, col=   4,red=0
                  50 row=  0, col=   5,red=0
                  60 row=  0, col=   6,red=0
                  70 row=  1, col=   0,red=0
                  80 row=  1, col=   1,red=0
                  90 row=  1, col=   2,red=0
                 100 row=  1, col=   3,red=f
                 110 row=  1, col=   4,red=f
                 120 row=  1, col=   5,red=f
                 130 row=  1, col=   6,red=0
                 140 row=  2, col=   0,red=0
                 150 row=  2, col=   1,red=0
                 160 row=  2, col=   2,red=f
                 170 row=  2, col=   3,red=0
                 180 row=  2, col=   4,red=0
                 190 row=  2, col=   5,red=f
                 200 row=  2, col=   6,red=f
                 210 row=  3, col=   0,red=0
                 220 row=  3, col=   1,red=f
                 230 row=  3, col=   2,red=f
                 240 row=  3, col=   3,red=0
                 250 row=  3, col=   4,red=0
                 260 row=  3, col=   5,red=0
                 270 row=  3, col=   6,red=f
                 280 row=  4, col=   0,red=0
                 290 row=  4, col=   1,red=f
                 300 row=  4, col=   2,red=f
                 310 row=  4, col=   3,red=0
                 320 row=  4, col=   4,red=0
                 330 row=  4, col=   5,red=0
                 340 row=  4, col=   6,red=f
                 350 row=  5, col=   0,red=0
                 360 row=  5, col=   1,red=f
                 370 row=  5, col=   2,red=f
                 380 row=  5, col=   3,red=0
                 390 row=  5, col=   4,red=0
                 400 row=  5, col=   5,red=0
                 410 row=  5, col=   6,red=f
                 420 row=  6, col=   0,red=0
                 430 row=  6, col=   1,red=0
                 440 row=  6, col=   2,red=f
                 450 row=  6, col=   3,red=f
                 460 row=  6, col=   4,red=0
                 470 row=  6, col=   5,red=0
                 480 row=  6, col=   6,red=f
                 490 row=  7, col=   7,red=0
$finish called from file "dr_demo_test.sv", line 20.
$finish at simulation time                  500
